"filename", "language", "C#", "XML", "JSON", "C# (Unity)", "ShaderLab", "comment", "blank", "total"
"f:\SimpleRTS\SimpleRTS\Simplified_RTS\Assets\Photon\PhotonChat\Code\ChannelCreationOptions.cs", "C#", 12, 0, 0, 0, 0, 8, 3, 23
"f:\SimpleRTS\SimpleRTS\Simplified_RTS\Assets\Photon\PhotonChat\Code\ChannelWellKnownProperties.cs", "C#", 8, 0, 0, 0, 0, 5, 2, 15
"f:\SimpleRTS\SimpleRTS\Simplified_RTS\Assets\Photon\PhotonChat\Code\ChatAppSettings.cs", "C#", 21, 0, 0, 0, 0, 20, 10, 51
"f:\SimpleRTS\SimpleRTS\Simplified_RTS\Assets\Photon\PhotonChat\Code\ChatChannel.cs", "C#", 131, 0, 0, 0, 0, 34, 28, 193
"f:\SimpleRTS\SimpleRTS\Simplified_RTS\Assets\Photon\PhotonChat\Code\ChatClient.cs", "C#", 1263, 0, 0, 0, 0, 338, 165, 1766
"f:\SimpleRTS\SimpleRTS\Simplified_RTS\Assets\Photon\PhotonChat\Code\ChatDisconnectCause.cs", "C#", 20, 0, 0, 0, 0, 21, 2, 43
"f:\SimpleRTS\SimpleRTS\Simplified_RTS\Assets\Photon\PhotonChat\Code\ChatEventCode.cs", "C#", 17, 0, 0, 0, 0, 20, 3, 40
"f:\SimpleRTS\SimpleRTS\Simplified_RTS\Assets\Photon\PhotonChat\Code\ChatOperationCode.cs", "C#", 16, 0, 0, 0, 0, 18, 4, 38
"f:\SimpleRTS\SimpleRTS\Simplified_RTS\Assets\Photon\PhotonChat\Code\ChatParameterCode.cs", "C#", 31, 0, 0, 0, 0, 47, 7, 85
"f:\SimpleRTS\SimpleRTS\Simplified_RTS\Assets\Photon\PhotonChat\Code\ChatPeer.cs", "C#", 215, 0, 0, 0, 0, 148, 71, 434
"f:\SimpleRTS\SimpleRTS\Simplified_RTS\Assets\Photon\PhotonChat\Code\ChatState.cs", "C#", 18, 0, 0, 0, 0, 18, 1, 37
"f:\SimpleRTS\SimpleRTS\Simplified_RTS\Assets\Photon\PhotonChat\Code\ChatUserStatus.cs", "C#", 13, 0, 0, 0, 0, 21, 2, 36
"f:\SimpleRTS\SimpleRTS\Simplified_RTS\Assets\Photon\PhotonChat\Code\IChatClientListener.cs", "C#", 27, 0, 0, 0, 0, 99, 22, 148
"f:\SimpleRTS\SimpleRTS\Simplified_RTS\Assets\Photon\PhotonChat\Demos\Common\EventSystemSpawner.cs", "C#", 18, 0, 0, 0, 0, 13, 3, 34
"f:\SimpleRTS\SimpleRTS\Simplified_RTS\Assets\Photon\PhotonChat\Demos\Common\OnStartDelete.cs", "C#", 11, 0, 0, 0, 0, 11, 2, 24
"f:\SimpleRTS\SimpleRTS\Simplified_RTS\Assets\Photon\PhotonChat\Demos\Common\TextButtonTransition.cs", "C#", 38, 0, 0, 0, 0, 20, 12, 70
"f:\SimpleRTS\SimpleRTS\Simplified_RTS\Assets\Photon\PhotonChat\Demos\Common\TextToggleIsOnTransition.cs", "C#", 41, 0, 0, 0, 0, 26, 19, 86
"f:\SimpleRTS\SimpleRTS\Simplified_RTS\Assets\Photon\PhotonChat\Demos\DemoChat\AppSettingsExtensions.cs", "C#", 17, 0, 0, 0, 0, 0, 2, 19
"f:\SimpleRTS\SimpleRTS\Simplified_RTS\Assets\Photon\PhotonChat\Demos\DemoChat\ChannelSelector.cs", "C#", 19, 0, 0, 0, 0, 0, 4, 23
"f:\SimpleRTS\SimpleRTS\Simplified_RTS\Assets\Photon\PhotonChat\Demos\DemoChat\ChatAppIdCheckerUI.cs", "C#", 32, 0, 0, 0, 0, 10, 7, 49
"f:\SimpleRTS\SimpleRTS\Simplified_RTS\Assets\Photon\PhotonChat\Demos\DemoChat\ChatGui.cs", "C#", 459, 0, 0, 0, 0, 70, 117, 646
"f:\SimpleRTS\SimpleRTS\Simplified_RTS\Assets\Photon\PhotonChat\Demos\DemoChat\DemoChat-Scene.unity", "C# (Unity)", 0, 0, 0, 6243, 0, 0, 4, 6247
"f:\SimpleRTS\SimpleRTS\Simplified_RTS\Assets\Photon\PhotonChat\Demos\DemoChat\FriendItem.cs", "C#", 64, 0, 0, 0, 0, 5, 12, 81
"f:\SimpleRTS\SimpleRTS\Simplified_RTS\Assets\Photon\PhotonChat\Demos\DemoChat\IgnoreUiRaycastWhenInactive.cs", "C#", 8, 0, 0, 0, 0, 0, 2, 10
"f:\SimpleRTS\SimpleRTS\Simplified_RTS\Assets\Photon\PhotonChat\Demos\DemoChat\NamePickGui.cs", "C#", 33, 0, 0, 0, 0, 1, 10, 44
"f:\SimpleRTS\SimpleRTS\Simplified_RTS\Assets\Photon\PhotonLibs\Photon3Unity3D.xml", "XML", 0, 2639, 0, 0, 0, 0, 72, 2711
"f:\SimpleRTS\SimpleRTS\Simplified_RTS\Assets\Photon\PhotonLibs\WebSocket\SocketWebTcp.cs", "C#", 209, 0, 0, 0, 0, 27, 47, 283
"f:\SimpleRTS\SimpleRTS\Simplified_RTS\Assets\Photon\PhotonLibs\WebSocket\WebSocket.cs", "C#", 136, 0, 0, 0, 0, 8, 33, 177
"f:\SimpleRTS\SimpleRTS\Simplified_RTS\Assets\Photon\PhotonLibs\netstandard2.0\Photon3Unity3D.deps.json", "JSON", 0, 0, 47, 0, 0, 0, 0, 47
"f:\SimpleRTS\SimpleRTS\Simplified_RTS\Assets\Photon\PhotonLibs\netstandard2.0\Photon3Unity3D.xml", "XML", 0, 2639, 0, 0, 0, 0, 72, 2711
"f:\SimpleRTS\SimpleRTS\Simplified_RTS\Assets\Photon\PhotonRealtime\Code\AppSettings.cs", "C#", 85, 0, 0, 0, 0, 50, 19, 154
"f:\SimpleRTS\SimpleRTS\Simplified_RTS\Assets\Photon\PhotonRealtime\Code\ConnectionHandler.cs", "C#", 124, 0, 0, 0, 0, 25, 37, 186
"f:\SimpleRTS\SimpleRTS\Simplified_RTS\Assets\Photon\PhotonRealtime\Code\Extensions.cs", "C#", 121, 0, 0, 0, 0, 65, 30, 216
"f:\SimpleRTS\SimpleRTS\Simplified_RTS\Assets\Photon\PhotonRealtime\Code\FriendInfo.cs", "C#", 27, 0, 0, 0, 0, 12, 10, 49
"f:\SimpleRTS\SimpleRTS\Simplified_RTS\Assets\Photon\PhotonRealtime\Code\LoadBalancingClient.cs", "C#", 451, 0, 0, 0, 0, 3572, 173, 4196
"f:\SimpleRTS\SimpleRTS\Simplified_RTS\Assets\Photon\PhotonRealtime\Code\LoadbalancingPeer.cs", "C#", 1053, 0, 0, 0, 0, 749, 389, 2191
"f:\SimpleRTS\SimpleRTS\Simplified_RTS\Assets\Photon\PhotonRealtime\Code\PhotonPing.cs", "C#", 369, 0, 0, 0, 0, 32, 76, 477
"f:\SimpleRTS\SimpleRTS\Simplified_RTS\Assets\Photon\PhotonRealtime\Code\PhotonPingClasses.cs", "C#", 0, 0, 0, 0, 0, 1, 0, 1
"f:\SimpleRTS\SimpleRTS\Simplified_RTS\Assets\Photon\PhotonRealtime\Code\Player.cs", "C#", 230, 0, 0, 0, 0, 164, 58, 452
"f:\SimpleRTS\SimpleRTS\Simplified_RTS\Assets\Photon\PhotonRealtime\Code\Region.cs", "C#", 63, 0, 0, 0, 0, 10, 17, 90
"f:\SimpleRTS\SimpleRTS\Simplified_RTS\Assets\Photon\PhotonRealtime\Code\RegionHandler.cs", "C#", 479, 0, 0, 0, 0, 83, 106, 668
"f:\SimpleRTS\SimpleRTS\Simplified_RTS\Assets\Photon\PhotonRealtime\Code\Room.cs", "C#", 293, 0, 0, 0, 0, 201, 65, 559
"f:\SimpleRTS\SimpleRTS\Simplified_RTS\Assets\Photon\PhotonRealtime\Code\RoomInfo.cs", "C#", 142, 0, 0, 0, 0, 89, 44, 275
"f:\SimpleRTS\SimpleRTS\Simplified_RTS\Assets\Photon\PhotonRealtime\Code\SupportLogger.cs", "C#", 306, 0, 0, 0, 0, 30, 63, 399
"f:\SimpleRTS\SimpleRTS\Simplified_RTS\Assets\Photon\PhotonRealtime\Code\WebRpc.cs", "C#", 123, 0, 0, 0, 0, 44, 21, 188
"f:\SimpleRTS\SimpleRTS\Simplified_RTS\Assets\Photon\PhotonRealtime\Demos\DemoLoadBalancing\ConnectAndJoinRandomLb.cs", "C#", 110, 0, 0, 0, 0, 3, 28, 141
"f:\SimpleRTS\SimpleRTS\Simplified_RTS\Assets\Photon\PhotonRealtime\Demos\DemoLoadBalancing\DemoLoadBalancing-Scene.unity", "C# (Unity)", 0, 0, 0, 711, 0, 0, 1, 712
"f:\SimpleRTS\SimpleRTS\Simplified_RTS\Assets\Photon\PhotonUnityNetworking\Code\CustomTypes.cs", "C#", 131, 0, 0, 0, 0, 14, 32, 177
"f:\SimpleRTS\SimpleRTS\Simplified_RTS\Assets\Photon\PhotonUnityNetworking\Code\Editor\AccountService.cs", "C#", 195, 0, 0, 0, 0, 36, 23, 254
"f:\SimpleRTS\SimpleRTS\Simplified_RTS\Assets\Photon\PhotonUnityNetworking\Code\Editor\PhotonEditor.cs", "C#", 590, 0, 0, 0, 0, 47, 149, 786
"f:\SimpleRTS\SimpleRTS\Simplified_RTS\Assets\Photon\PhotonUnityNetworking\Code\Editor\PhotonEditorUtils.cs", "C#", 215, 0, 0, 0, 0, 45, 44, 304
"f:\SimpleRTS\SimpleRTS\Simplified_RTS\Assets\Photon\PhotonUnityNetworking\Code\Editor\PhotonGUI.cs", "C#", 273, 0, 0, 0, 0, 11, 79, 363
"f:\SimpleRTS\SimpleRTS\Simplified_RTS\Assets\Photon\PhotonUnityNetworking\Code\Editor\PhotonViewHandler.cs", "C#", 123, 0, 0, 0, 0, 28, 37, 188
"f:\SimpleRTS\SimpleRTS\Simplified_RTS\Assets\Photon\PhotonUnityNetworking\Code\Editor\PhotonViewInspector.cs", "C#", 281, 0, 0, 0, 0, 38, 67, 386
"f:\SimpleRTS\SimpleRTS\Simplified_RTS\Assets\Photon\PhotonUnityNetworking\Code\Editor\PunSceneSettings.cs", "C#", 131, 0, 0, 0, 0, 16, 31, 178
"f:\SimpleRTS\SimpleRTS\Simplified_RTS\Assets\Photon\PhotonUnityNetworking\Code\Editor\PunSceneSettingsInspector.cs", "C#", 186, 0, 0, 0, 0, 18, 56, 260
"f:\SimpleRTS\SimpleRTS\Simplified_RTS\Assets\Photon\PhotonUnityNetworking\Code\Editor\ReordableList\ReorderableListResources.cs", "C#", 134, 0, 0, 0, 0, 71, 32, 237
"f:\SimpleRTS\SimpleRTS\Simplified_RTS\Assets\Photon\PhotonUnityNetworking\Code\Editor\ServerSettingsInspector.cs", "C#", 219, 0, 0, 0, 0, 15, 68, 302
"f:\SimpleRTS\SimpleRTS\Simplified_RTS\Assets\Photon\PhotonUnityNetworking\Code\Editor\Views\MonoBehaviourPunEditor.cs", "C#", 23, 0, 0, 0, 0, 9, 9, 41
"f:\SimpleRTS\SimpleRTS\Simplified_RTS\Assets\Photon\PhotonUnityNetworking\Code\Editor\Views\PhotonAnimatorViewEditor.cs", "C#", 227, 0, 0, 0, 0, 14, 55, 296
"f:\SimpleRTS\SimpleRTS\Simplified_RTS\Assets\Photon\PhotonUnityNetworking\Code\Editor\Views\PhotonRigidbody2DViewEditor.cs", "C#", 31, 0, 0, 0, 0, 9, 10, 50
"f:\SimpleRTS\SimpleRTS\Simplified_RTS\Assets\Photon\PhotonUnityNetworking\Code\Editor\Views\PhotonRigidbodyViewEditor.cs", "C#", 31, 0, 0, 0, 0, 9, 10, 50
"f:\SimpleRTS\SimpleRTS\Simplified_RTS\Assets\Photon\PhotonUnityNetworking\Code\Editor\Views\PhotonTransformViewClassicEditor.cs", "C#", 297, 0, 0, 0, 0, 34, 81, 412
"f:\SimpleRTS\SimpleRTS\Simplified_RTS\Assets\Photon\PhotonUnityNetworking\Code\Editor\Views\PhotonTransformViewEditor.cs", "C#", 32, 0, 0, 0, 0, 9, 11, 52
"f:\SimpleRTS\SimpleRTS\Simplified_RTS\Assets\Photon\PhotonUnityNetworking\Code\Enums.cs", "C#", 27, 0, 0, 0, 0, 49, 18, 94
"f:\SimpleRTS\SimpleRTS\Simplified_RTS\Assets\Photon\PhotonUnityNetworking\Code\PhotonHandler.cs", "C#", 250, 0, 0, 0, 0, 48, 75, 373
"f:\SimpleRTS\SimpleRTS\Simplified_RTS\Assets\Photon\PhotonUnityNetworking\Code\PhotonNetwork.cs", "C#", 1631, 0, 0, 0, 0, 1166, 375, 3172
"f:\SimpleRTS\SimpleRTS\Simplified_RTS\Assets\Photon\PhotonUnityNetworking\Code\PhotonNetworkPart.cs", "C#", 1680, 0, 0, 0, 0, 417, 387, 2484
"f:\SimpleRTS\SimpleRTS\Simplified_RTS\Assets\Photon\PhotonUnityNetworking\Code\PhotonStreamQueue.cs", "C#", 113, 0, 0, 0, 0, 52, 32, 197
"f:\SimpleRTS\SimpleRTS\Simplified_RTS\Assets\Photon\PhotonUnityNetworking\Code\PhotonView.cs", "C#", 499, 0, 0, 0, 0, 216, 126, 841
"f:\SimpleRTS\SimpleRTS\Simplified_RTS\Assets\Photon\PhotonUnityNetworking\Code\PunClasses.cs", "C#", 531, 0, 0, 0, 0, 457, 113, 1101
"f:\SimpleRTS\SimpleRTS\Simplified_RTS\Assets\Photon\PhotonUnityNetworking\Code\ServerSettings.cs", "C#", 62, 0, 0, 0, 0, 23, 15, 100
"f:\SimpleRTS\SimpleRTS\Simplified_RTS\Assets\Photon\PhotonUnityNetworking\Code\Utilities\NestedComponentUtilities.cs", "C#", 221, 0, 0, 0, 0, 84, 81, 386
"f:\SimpleRTS\SimpleRTS\Simplified_RTS\Assets\Photon\PhotonUnityNetworking\Code\Views\PhotonAnimatorView.cs", "C#", 408, 0, 0, 0, 0, 68, 96, 572
"f:\SimpleRTS\SimpleRTS\Simplified_RTS\Assets\Photon\PhotonUnityNetworking\Code\Views\PhotonRigidbody2DView.cs", "C#", 79, 0, 0, 0, 0, 9, 23, 111
"f:\SimpleRTS\SimpleRTS\Simplified_RTS\Assets\Photon\PhotonUnityNetworking\Code\Views\PhotonRigidbodyView.cs", "C#", 80, 0, 0, 0, 0, 9, 23, 112
"f:\SimpleRTS\SimpleRTS\Simplified_RTS\Assets\Photon\PhotonUnityNetworking\Code\Views\PhotonTransformView.cs", "C#", 98, 0, 0, 0, 0, 9, 24, 131
"f:\SimpleRTS\SimpleRTS\Simplified_RTS\Assets\Photon\PhotonUnityNetworking\Code\Views\PhotonTransformViewClassic.cs", "C#", 389, 0, 0, 0, 0, 70, 98, 557
"f:\SimpleRTS\SimpleRTS\Simplified_RTS\Assets\Photon\PhotonUnityNetworking\Demos\DemoAsteroids\Scenes\DemoAsteroids-GameScene.unity", "C# (Unity)", 0, 0, 0, 4053, 0, 0, 1, 4054
"f:\SimpleRTS\SimpleRTS\Simplified_RTS\Assets\Photon\PhotonUnityNetworking\Demos\DemoAsteroids\Scenes\DemoAsteroids-LobbyScene.unity", "C# (Unity)", 0, 0, 0, 5045, 0, 0, 1, 5046
"f:\SimpleRTS\SimpleRTS\Simplified_RTS\Assets\Photon\PhotonUnityNetworking\Demos\DemoAsteroids\Scripts\AsteroidsGame.cs", "C#", 29, 0, 0, 0, 0, 0, 6, 35
"f:\SimpleRTS\SimpleRTS\Simplified_RTS\Assets\Photon\PhotonUnityNetworking\Demos\DemoAsteroids\Scripts\Game\Asteroid.cs", "C#", 88, 0, 0, 0, 0, 10, 25, 123
"f:\SimpleRTS\SimpleRTS\Simplified_RTS\Assets\Photon\PhotonUnityNetworking\Demos\DemoAsteroids\Scripts\Game\AsteroidsGameManager.cs", "C#", 192, 0, 0, 0, 0, 17, 58, 267
"f:\SimpleRTS\SimpleRTS\Simplified_RTS\Assets\Photon\PhotonUnityNetworking\Demos\DemoAsteroids\Scripts\Game\Bullet.cs", "C#", 25, 0, 0, 0, 0, 0, 6, 31
"f:\SimpleRTS\SimpleRTS\Simplified_RTS\Assets\Photon\PhotonUnityNetworking\Demos\DemoAsteroids\Scripts\Game\PlayerOverviewPanel.cs", "C#", 44, 0, 0, 0, 0, 9, 14, 67
"f:\SimpleRTS\SimpleRTS\Simplified_RTS\Assets\Photon\PhotonUnityNetworking\Demos\DemoAsteroids\Scripts\Game\Spaceship.cs", "C#", 146, 0, 0, 0, 0, 19, 49, 214
"f:\SimpleRTS\SimpleRTS\Simplified_RTS\Assets\Photon\PhotonUnityNetworking\Demos\DemoAsteroids\Scripts\Lobby\LobbyMainPanel.cs", "C#", 282, 0, 0, 0, 0, 3, 76, 361
"f:\SimpleRTS\SimpleRTS\Simplified_RTS\Assets\Photon\PhotonUnityNetworking\Demos\DemoAsteroids\Scripts\Lobby\LobbyTopPanel.cs", "C#", 17, 0, 0, 0, 0, 0, 5, 22
"f:\SimpleRTS\SimpleRTS\Simplified_RTS\Assets\Photon\PhotonUnityNetworking\Demos\DemoAsteroids\Scripts\Lobby\PlayerListEntry.cs", "C#", 72, 0, 0, 0, 0, 9, 16, 97
"f:\SimpleRTS\SimpleRTS\Simplified_RTS\Assets\Photon\PhotonUnityNetworking\Demos\DemoAsteroids\Scripts\Lobby\RoomListEntry.cs", "C#", 29, 0, 0, 0, 0, 0, 6, 35
"f:\SimpleRTS\SimpleRTS\Simplified_RTS\Assets\Photon\PhotonUnityNetworking\Demos\DemoHub\DemoHub-Scene.unity", "C# (Unity)", 0, 0, 0, 10191, 0, 0, 4, 10195
"f:\SimpleRTS\SimpleRTS\Simplified_RTS\Assets\Photon\PhotonUnityNetworking\Demos\DemoHub\Editor\PunStartup.cs", "C#", 109, 0, 0, 0, 0, 18, 26, 153
"f:\SimpleRTS\SimpleRTS\Simplified_RTS\Assets\Photon\PhotonUnityNetworking\Demos\DemoHub\Scripts\DemoHubManager.cs", "C#", 258, 0, 0, 0, 0, 11, 42, 311
"f:\SimpleRTS\SimpleRTS\Simplified_RTS\Assets\Photon\PhotonUnityNetworking\Demos\DemoHub\Scripts\ToDemoHubButton.cs", "C#", 58, 0, 0, 0, 0, 13, 22, 93
"f:\SimpleRTS\SimpleRTS\Simplified_RTS\Assets\Photon\PhotonUnityNetworking\Demos\DemoProcedural\Procedural-Scene.unity", "C# (Unity)", 0, 0, 0, 4439, 0, 0, 1, 4440
"f:\SimpleRTS\SimpleRTS\Simplified_RTS\Assets\Photon\PhotonUnityNetworking\Demos\DemoProcedural\Scripts\Block.cs", "C#", 9, 0, 0, 0, 0, 4, 1, 14
"f:\SimpleRTS\SimpleRTS\Simplified_RTS\Assets\Photon\PhotonUnityNetworking\Demos\DemoProcedural\Scripts\Cluster.cs", "C#", 100, 0, 0, 0, 0, 42, 36, 178
"f:\SimpleRTS\SimpleRTS\Simplified_RTS\Assets\Photon\PhotonUnityNetworking\Demos\DemoProcedural\Scripts\IngameControlPanel.cs", "C#", 219, 0, 0, 0, 0, 29, 21, 269
"f:\SimpleRTS\SimpleRTS\Simplified_RTS\Assets\Photon\PhotonUnityNetworking\Demos\DemoProcedural\Scripts\Noise.cs", "C#", 273, 0, 0, 0, 0, 66, 54, 393
"f:\SimpleRTS\SimpleRTS\Simplified_RTS\Assets\Photon\PhotonUnityNetworking\Demos\DemoProcedural\Scripts\ProceduralController.cs", "C#", 63, 0, 0, 0, 0, 9, 11, 83
"f:\SimpleRTS\SimpleRTS\Simplified_RTS\Assets\Photon\PhotonUnityNetworking\Demos\DemoProcedural\Scripts\WorldGenerator.cs", "C#", 184, 0, 0, 0, 0, 48, 57, 289
"f:\SimpleRTS\SimpleRTS\Simplified_RTS\Assets\Photon\PhotonUnityNetworking\Demos\DemoSlotRacer\Scripts\BezierCurve\Bezier.cs", "C#", 41, 0, 0, 0, 0, 10, 5, 56
"f:\SimpleRTS\SimpleRTS\Simplified_RTS\Assets\Photon\PhotonUnityNetworking\Demos\DemoSlotRacer\Scripts\BezierCurve\BezierControlPointMode.cs", "C#", 8, 0, 0, 0, 0, 10, 1, 19
"f:\SimpleRTS\SimpleRTS\Simplified_RTS\Assets\Photon\PhotonUnityNetworking\Demos\DemoSlotRacer\Scripts\BezierCurve\BezierCurve.cs", "C#", 29, 0, 0, 0, 0, 10, 6, 45
"f:\SimpleRTS\SimpleRTS\Simplified_RTS\Assets\Photon\PhotonUnityNetworking\Demos\DemoSlotRacer\Scripts\BezierCurve\BezierSpline.cs", "C#", 263, 0, 0, 0, 0, 22, 47, 332
"f:\SimpleRTS\SimpleRTS\Simplified_RTS\Assets\Photon\PhotonUnityNetworking\Demos\DemoSlotRacer\Scripts\BezierCurve\Editor\BezierCurveInspector.cs", "C#", 54, 0, 0, 0, 0, 10, 9, 73
"f:\SimpleRTS\SimpleRTS\Simplified_RTS\Assets\Photon\PhotonUnityNetworking\Demos\DemoSlotRacer\Scripts\BezierCurve\Editor\BezierSplineInspector.cs", "C#", 127, 0, 0, 0, 0, 10, 17, 154
"f:\SimpleRTS\SimpleRTS\Simplified_RTS\Assets\Photon\PhotonUnityNetworking\Demos\DemoSlotRacer\Scripts\BezierCurve\Editor\LineInspector.cs", "C#", 33, 0, 0, 0, 0, 10, 4, 47
"f:\SimpleRTS\SimpleRTS\Simplified_RTS\Assets\Photon\PhotonUnityNetworking\Demos\DemoSlotRacer\Scripts\BezierCurve\Line.cs", "C#", 7, 0, 0, 0, 0, 10, 2, 19
"f:\SimpleRTS\SimpleRTS\Simplified_RTS\Assets\Photon\PhotonUnityNetworking\Demos\DemoSlotRacer\Scripts\BezierCurve\SplinePosition.cs", "C#", 34, 0, 0, 0, 0, 11, 12, 57
"f:\SimpleRTS\SimpleRTS\Simplified_RTS\Assets\Photon\PhotonUnityNetworking\Demos\DemoSlotRacer\Scripts\BezierCurve\SplineWalker.cs", "C#", 36, 0, 0, 0, 0, 13, 15, 64
"f:\SimpleRTS\SimpleRTS\Simplified_RTS\Assets\Photon\PhotonUnityNetworking\Demos\DemoSlotRacer\Scripts\PlayerControl.cs", "C#", 116, 0, 0, 0, 0, 72, 44, 232
"f:\SimpleRTS\SimpleRTS\Simplified_RTS\Assets\Photon\PhotonUnityNetworking\Demos\DemoSlotRacer\Scripts\SlotLanes.cs", "C#", 13, 0, 0, 0, 0, 19, 6, 38
"f:\SimpleRTS\SimpleRTS\Simplified_RTS\Assets\Photon\PhotonUnityNetworking\Demos\DemoSlotRacer\Scripts\SlotRacerSplashScreen.cs", "C#", 70, 0, 0, 0, 0, 13, 13, 96
"f:\SimpleRTS\SimpleRTS\Simplified_RTS\Assets\Photon\PhotonUnityNetworking\Demos\DemoSlotRacer\SlotCar-Scene.unity", "C# (Unity)", 0, 0, 0, 18967, 0, 0, 1, 18968
"f:\SimpleRTS\SimpleRTS\Simplified_RTS\Assets\Photon\PhotonUnityNetworking\Demos\PunBasics-Tutorial\Scenes\PunBasics-Launcher.unity", "C# (Unity)", 0, 0, 0, 4644, 0, 0, 1, 4645
"f:\SimpleRTS\SimpleRTS\Simplified_RTS\Assets\Photon\PhotonUnityNetworking\Demos\PunBasics-Tutorial\Scenes\PunBasics-Room for 1.unity", "C# (Unity)", 0, 0, 0, 1187, 0, 0, 1, 1188
"f:\SimpleRTS\SimpleRTS\Simplified_RTS\Assets\Photon\PhotonUnityNetworking\Demos\PunBasics-Tutorial\Scenes\PunBasics-Room for 2.unity", "C# (Unity)", 0, 0, 0, 1187, 0, 0, 1, 1188
"f:\SimpleRTS\SimpleRTS\Simplified_RTS\Assets\Photon\PhotonUnityNetworking\Demos\PunBasics-Tutorial\Scenes\PunBasics-Room for 3.unity", "C# (Unity)", 0, 0, 0, 1187, 0, 0, 1, 1188
"f:\SimpleRTS\SimpleRTS\Simplified_RTS\Assets\Photon\PhotonUnityNetworking\Demos\PunBasics-Tutorial\Scenes\PunBasics-Room for 4.unity", "C# (Unity)", 0, 0, 0, 1187, 0, 0, 1, 1188
"f:\SimpleRTS\SimpleRTS\Simplified_RTS\Assets\Photon\PhotonUnityNetworking\Demos\PunBasics-Tutorial\Scripts\CameraWork.cs", "C#", 70, 0, 0, 0, 0, 30, 30, 130
"f:\SimpleRTS\SimpleRTS\Simplified_RTS\Assets\Photon\PhotonUnityNetworking\Demos\PunBasics-Tutorial\Scripts\GameManager.cs", "C#", 93, 0, 0, 0, 0, 35, 46, 174
"f:\SimpleRTS\SimpleRTS\Simplified_RTS\Assets\Photon\PhotonUnityNetworking\Demos\PunBasics-Tutorial\Scripts\Launcher.cs", "C#", 101, 0, 0, 0, 0, 77, 48, 226
"f:\SimpleRTS\SimpleRTS\Simplified_RTS\Assets\Photon\PhotonUnityNetworking\Demos\PunBasics-Tutorial\Scripts\LoaderAnime.cs", "C#", 45, 0, 0, 0, 0, 33, 23, 101
"f:\SimpleRTS\SimpleRTS\Simplified_RTS\Assets\Photon\PhotonUnityNetworking\Demos\PunBasics-Tutorial\Scripts\PlayerAnimatorManager.cs", "C#", 42, 0, 0, 0, 0, 23, 16, 81
"f:\SimpleRTS\SimpleRTS\Simplified_RTS\Assets\Photon\PhotonUnityNetworking\Demos\PunBasics-Tutorial\Scripts\PlayerManager.cs", "C#", 173, 0, 0, 0, 0, 67, 49, 289
"f:\SimpleRTS\SimpleRTS\Simplified_RTS\Assets\Photon\PhotonUnityNetworking\Demos\PunBasics-Tutorial\Scripts\PlayerNameInputField.cs", "C#", 39, 0, 0, 0, 0, 21, 15, 75
"f:\SimpleRTS\SimpleRTS\Simplified_RTS\Assets\Photon\PhotonUnityNetworking\Demos\PunBasics-Tutorial\Scripts\PlayerUI.cs", "C#", 73, 0, 0, 0, 0, 35, 39, 147
"f:\SimpleRTS\SimpleRTS\Simplified_RTS\Assets\Photon\PhotonUnityNetworking\Demos\PunCockpit\Forms\ConnectToRegionUIForm.cs", "C#", 36, 0, 0, 0, 0, 10, 11, 57
"f:\SimpleRTS\SimpleRTS\Simplified_RTS\Assets\Photon\PhotonUnityNetworking\Demos\PunCockpit\Forms\CreateRoomUiForm.cs", "C#", 48, 0, 0, 0, 0, 10, 13, 71
"f:\SimpleRTS\SimpleRTS\Simplified_RTS\Assets\Photon\PhotonUnityNetworking\Demos\PunCockpit\Forms\LoadLevelUIForm.cs", "C#", 28, 0, 0, 0, 0, 10, 9, 47
"f:\SimpleRTS\SimpleRTS\Simplified_RTS\Assets\Photon\PhotonUnityNetworking\Demos\PunCockpit\Forms\SetRoomCustomPropertyUIForm.cs", "C#", 28, 0, 0, 0, 0, 10, 9, 47
"f:\SimpleRTS\SimpleRTS\Simplified_RTS\Assets\Photon\PhotonUnityNetworking\Demos\PunCockpit\Forms\UserIdUiForm.cs", "C#", 34, 0, 0, 0, 0, 10, 10, 54
"f:\SimpleRTS\SimpleRTS\Simplified_RTS\Assets\Photon\PhotonUnityNetworking\Demos\PunCockpit\PunCockpit-Scene.unity", "C# (Unity)", 0, 0, 0, 72850, 0, 0, 21, 72871
"f:\SimpleRTS\SimpleRTS\Simplified_RTS\Assets\Photon\PhotonUnityNetworking\Demos\PunCockpit\PunCockpit.cs", "C#", 560, 0, 0, 0, 0, 38, 209, 807
"f:\SimpleRTS\SimpleRTS\Simplified_RTS\Assets\Photon\PhotonUnityNetworking\Demos\PunCockpit\Scripts\Autonomous UI\AutoSyncSceneToggle.cs", "C#", 39, 0, 0, 0, 0, 11, 11, 61
"f:\SimpleRTS\SimpleRTS\Simplified_RTS\Assets\Photon\PhotonUnityNetworking\Demos\PunCockpit\Scripts\Autonomous UI\BackgroundTimeOutField.cs", "C#", 48, 0, 0, 0, 0, 11, 9, 68
"f:\SimpleRTS\SimpleRTS\Simplified_RTS\Assets\Photon\PhotonUnityNetworking\Demos\PunCockpit\Scripts\Autonomous UI\CrcCheckToggle.cs", "C#", 39, 0, 0, 0, 0, 11, 11, 61
"f:\SimpleRTS\SimpleRTS\Simplified_RTS\Assets\Photon\PhotonUnityNetworking\Demos\PunCockpit\Scripts\Autonomous UI\CurrentRoom\CurrentRoomIsOpenToggle.cs", "C#", 43, 0, 0, 0, 0, 10, 13, 66
"f:\SimpleRTS\SimpleRTS\Simplified_RTS\Assets\Photon\PhotonUnityNetworking\Demos\PunCockpit\Scripts\Autonomous UI\CurrentRoom\CurrentRoomIsVisibleToggle.cs", "C#", 43, 0, 0, 0, 0, 10, 12, 65
"f:\SimpleRTS\SimpleRTS\Simplified_RTS\Assets\Photon\PhotonUnityNetworking\Demos\PunCockpit\Scripts\Autonomous UI\DocLinkButton.cs", "C#", 16, 0, 0, 0, 0, 11, 6, 33
"f:\SimpleRTS\SimpleRTS\Simplified_RTS\Assets\Photon\PhotonUnityNetworking\Demos\PunCockpit\Scripts\Autonomous UI\GameVersionField.cs", "C#", 48, 0, 0, 0, 0, 11, 9, 68
"f:\SimpleRTS\SimpleRTS\Simplified_RTS\Assets\Photon\PhotonUnityNetworking\Demos\PunCockpit\Scripts\Autonomous UI\Generic\BoolInputField.cs", "C#", 35, 0, 0, 0, 0, 9, 10, 54
"f:\SimpleRTS\SimpleRTS\Simplified_RTS\Assets\Photon\PhotonUnityNetworking\Demos\PunCockpit\Scripts\Autonomous UI\Generic\IntInputField.cs", "C#", 48, 0, 0, 0, 0, 9, 10, 67
"f:\SimpleRTS\SimpleRTS\Simplified_RTS\Assets\Photon\PhotonUnityNetworking\Demos\PunCockpit\Scripts\Autonomous UI\Generic\StringInputField.cs", "C#", 46, 0, 0, 0, 0, 9, 10, 65
"f:\SimpleRTS\SimpleRTS\Simplified_RTS\Assets\Photon\PhotonUnityNetworking\Demos\PunCockpit\Scripts\Autonomous UI\Generic\ToggleExpand.cs", "C#", 25, 0, 0, 0, 0, 9, 11, 45
"f:\SimpleRTS\SimpleRTS\Simplified_RTS\Assets\Photon\PhotonUnityNetworking\Demos\PunCockpit\Scripts\Autonomous UI\LayoutElementMatchSize.cs", "C#", 22, 0, 0, 0, 0, 9, 9, 40
"f:\SimpleRTS\SimpleRTS\Simplified_RTS\Assets\Photon\PhotonUnityNetworking\Demos\PunCockpit\Scripts\Autonomous UI\NickNameField.cs", "C#", 48, 0, 0, 0, 0, 11, 9, 68
"f:\SimpleRTS\SimpleRTS\Simplified_RTS\Assets\Photon\PhotonUnityNetworking\Demos\PunCockpit\Scripts\Autonomous UI\OnlineDocButton.cs", "C#", 13, 0, 0, 0, 0, 10, 4, 27
"f:\SimpleRTS\SimpleRTS\Simplified_RTS\Assets\Photon\PhotonUnityNetworking\Demos\PunCockpit\Scripts\Autonomous UI\SendRateField.cs", "C#", 48, 0, 0, 0, 0, 11, 11, 70
"f:\SimpleRTS\SimpleRTS\Simplified_RTS\Assets\Photon\PhotonUnityNetworking\Demos\PunCockpit\Scripts\Autonomous UI\SendRateOnSerializeField.cs", "C#", 48, 0, 0, 0, 0, 11, 10, 69
"f:\SimpleRTS\SimpleRTS\Simplified_RTS\Assets\Photon\PhotonUnityNetworking\Demos\PunCockpit\Scripts\Controllers\PlayerDetailsController.cs", "C#", 157, 0, 0, 0, 0, 14, 62, 233
"f:\SimpleRTS\SimpleRTS\Simplified_RTS\Assets\Photon\PhotonUnityNetworking\Demos\PunCockpit\Scripts\InfosPanelPlaceholder.cs", "C#", 12, 0, 0, 0, 0, 9, 4, 25
"f:\SimpleRTS\SimpleRTS\Simplified_RTS\Assets\Photon\PhotonUnityNetworking\Demos\PunCockpit\Scripts\Lists\FriendListCell.cs", "C#", 37, 0, 0, 0, 0, 10, 16, 63
"f:\SimpleRTS\SimpleRTS\Simplified_RTS\Assets\Photon\PhotonUnityNetworking\Demos\PunCockpit\Scripts\Lists\FriendListView.cs", "C#", 109, 0, 0, 0, 0, 14, 39, 162
"f:\SimpleRTS\SimpleRTS\Simplified_RTS\Assets\Photon\PhotonUnityNetworking\Demos\PunCockpit\Scripts\Lists\PlayerListCell.cs", "C#", 83, 0, 0, 0, 0, 14, 37, 134
"f:\SimpleRTS\SimpleRTS\Simplified_RTS\Assets\Photon\PhotonUnityNetworking\Demos\PunCockpit\Scripts\Lists\PlayerListView.cs", "C#", 117, 0, 0, 0, 0, 27, 40, 184
"f:\SimpleRTS\SimpleRTS\Simplified_RTS\Assets\Photon\PhotonUnityNetworking\Demos\PunCockpit\Scripts\Lists\PropertyCell.cs", "C#", 71, 0, 0, 0, 0, 9, 21, 101
"f:\SimpleRTS\SimpleRTS\Simplified_RTS\Assets\Photon\PhotonUnityNetworking\Demos\PunCockpit\Scripts\Lists\RegionListCell.cs", "C#", 53, 0, 0, 0, 0, 9, 19, 81
"f:\SimpleRTS\SimpleRTS\Simplified_RTS\Assets\Photon\PhotonUnityNetworking\Demos\PunCockpit\Scripts\Lists\RegionListView.cs", "C#", 39, 0, 0, 0, 0, 10, 15, 64
"f:\SimpleRTS\SimpleRTS\Simplified_RTS\Assets\Photon\PhotonUnityNetworking\Demos\PunCockpit\Scripts\Lists\RoomListCell.cs", "C#", 75, 0, 0, 0, 0, 9, 18, 102
"f:\SimpleRTS\SimpleRTS\Simplified_RTS\Assets\Photon\PhotonUnityNetworking\Demos\PunCockpit\Scripts\Lists\RoomListView.cs", "C#", 98, 0, 0, 0, 0, 12, 37, 147
"f:\SimpleRTS\SimpleRTS\Simplified_RTS\Assets\Photon\PhotonUnityNetworking\Demos\PunCockpit\Scripts\PropertyFields\UserIdField.cs", "C#", 49, 0, 0, 0, 0, 11, 11, 71
"f:\SimpleRTS\SimpleRTS\Simplified_RTS\Assets\Photon\PhotonUnityNetworking\Demos\PunCockpit\Scripts\ReadOnlyProperties\AppVersionProperty.cs", "C#", 18, 0, 0, 0, 0, 9, 5, 32
"f:\SimpleRTS\SimpleRTS\Simplified_RTS\Assets\Photon\PhotonUnityNetworking\Demos\PunCockpit\Scripts\ReadOnlyProperties\BestRegionInPrefsProperty.cs", "C#", 25, 0, 0, 0, 0, 9, 6, 40
"f:\SimpleRTS\SimpleRTS\Simplified_RTS\Assets\Photon\PhotonUnityNetworking\Demos\PunCockpit\Scripts\ReadOnlyProperties\CloudRegionProperty.cs", "C#", 25, 0, 0, 0, 0, 9, 4, 38
"f:\SimpleRTS\SimpleRTS\Simplified_RTS\Assets\Photon\PhotonUnityNetworking\Demos\PunCockpit\Scripts\ReadOnlyProperties\CountOfPlayersInRoomProperty.cs", "C#", 30, 0, 0, 0, 0, 9, 5, 44
"f:\SimpleRTS\SimpleRTS\Simplified_RTS\Assets\Photon\PhotonUnityNetworking\Demos\PunCockpit\Scripts\ReadOnlyProperties\CountOfPlayersOnMasterProperty.cs", "C#", 30, 0, 0, 0, 0, 9, 5, 44
"f:\SimpleRTS\SimpleRTS\Simplified_RTS\Assets\Photon\PhotonUnityNetworking\Demos\PunCockpit\Scripts\ReadOnlyProperties\CountOfPlayersProperty.cs", "C#", 30, 0, 0, 0, 0, 9, 5, 44
"f:\SimpleRTS\SimpleRTS\Simplified_RTS\Assets\Photon\PhotonUnityNetworking\Demos\PunCockpit\Scripts\ReadOnlyProperties\CountOfRoomsProperty.cs", "C#", 30, 0, 0, 0, 0, 9, 4, 43
"f:\SimpleRTS\SimpleRTS\Simplified_RTS\Assets\Photon\PhotonUnityNetworking\Demos\PunCockpit\Scripts\ReadOnlyProperties\CurrentRoomAutoCleanupProperty.cs", "C#", 29, 0, 0, 0, 0, 9, 6, 44
"f:\SimpleRTS\SimpleRTS\Simplified_RTS\Assets\Photon\PhotonUnityNetworking\Demos\PunCockpit\Scripts\ReadOnlyProperties\CurrentRoomEmptyRoomTtlProperty.cs", "C#", 29, 0, 0, 0, 0, 9, 5, 43
"f:\SimpleRTS\SimpleRTS\Simplified_RTS\Assets\Photon\PhotonUnityNetworking\Demos\PunCockpit\Scripts\ReadOnlyProperties\CurrentRoomExpectedUsersProperty.cs", "C#", 34, 0, 0, 0, 0, 9, 15, 58
"f:\SimpleRTS\SimpleRTS\Simplified_RTS\Assets\Photon\PhotonUnityNetworking\Demos\PunCockpit\Scripts\ReadOnlyProperties\CurrentRoomIsOfflineProperty.cs", "C#", 29, 0, 0, 0, 0, 9, 6, 44
"f:\SimpleRTS\SimpleRTS\Simplified_RTS\Assets\Photon\PhotonUnityNetworking\Demos\PunCockpit\Scripts\ReadOnlyProperties\CurrentRoomIsOpenProperty.cs", "C#", 29, 0, 0, 0, 0, 9, 4, 42
"f:\SimpleRTS\SimpleRTS\Simplified_RTS\Assets\Photon\PhotonUnityNetworking\Demos\PunCockpit\Scripts\ReadOnlyProperties\CurrentRoomIsVisibleProperty.cs", "C#", 29, 0, 0, 0, 0, 9, 6, 44
"f:\SimpleRTS\SimpleRTS\Simplified_RTS\Assets\Photon\PhotonUnityNetworking\Demos\PunCockpit\Scripts\ReadOnlyProperties\CurrentRoomMasterClientIdProperty.cs", "C#", 29, 0, 0, 0, 0, 9, 4, 42
"f:\SimpleRTS\SimpleRTS\Simplified_RTS\Assets\Photon\PhotonUnityNetworking\Demos\PunCockpit\Scripts\ReadOnlyProperties\CurrentRoomMaxPlayersProperty.cs", "C#", 29, 0, 0, 0, 0, 9, 4, 42
"f:\SimpleRTS\SimpleRTS\Simplified_RTS\Assets\Photon\PhotonUnityNetworking\Demos\PunCockpit\Scripts\ReadOnlyProperties\CurrentRoomNameProperty.cs", "C#", 29, 0, 0, 0, 0, 9, 5, 43
"f:\SimpleRTS\SimpleRTS\Simplified_RTS\Assets\Photon\PhotonUnityNetworking\Demos\PunCockpit\Scripts\ReadOnlyProperties\CurrentRoomPlayerCountProperty.cs", "C#", 29, 0, 0, 0, 0, 9, 4, 42
"f:\SimpleRTS\SimpleRTS\Simplified_RTS\Assets\Photon\PhotonUnityNetworking\Demos\PunCockpit\Scripts\ReadOnlyProperties\CurrentRoomPlayerTtlProperty.cs", "C#", 29, 0, 0, 0, 0, 9, 5, 43
"f:\SimpleRTS\SimpleRTS\Simplified_RTS\Assets\Photon\PhotonUnityNetworking\Demos\PunCockpit\Scripts\ReadOnlyProperties\CurrentRoomPropertiesListedInLobbyProperty.cs", "C#", 30, 0, 0, 0, 0, 9, 8, 47
"f:\SimpleRTS\SimpleRTS\Simplified_RTS\Assets\Photon\PhotonUnityNetworking\Demos\PunCockpit\Scripts\ReadOnlyProperties\GameVersionProperty.cs", "C#", 17, 0, 0, 0, 0, 9, 4, 30
"f:\SimpleRTS\SimpleRTS\Simplified_RTS\Assets\Photon\PhotonUnityNetworking\Demos\PunCockpit\Scripts\ReadOnlyProperties\IsConnectedAndReadyProperty.cs", "C#", 18, 0, 0, 0, 0, 9, 6, 33
"f:\SimpleRTS\SimpleRTS\Simplified_RTS\Assets\Photon\PhotonUnityNetworking\Demos\PunCockpit\Scripts\ReadOnlyProperties\IsConnectedProperty.cs", "C#", 18, 0, 0, 0, 0, 9, 5, 32
"f:\SimpleRTS\SimpleRTS\Simplified_RTS\Assets\Photon\PhotonUnityNetworking\Demos\PunCockpit\Scripts\ReadOnlyProperties\OfflineModeProperty.cs", "C#", 18, 0, 0, 0, 0, 9, 5, 32
"f:\SimpleRTS\SimpleRTS\Simplified_RTS\Assets\Photon\PhotonUnityNetworking\Demos\PunCockpit\Scripts\ReadOnlyProperties\PingProperty.cs", "C#", 29, 0, 0, 0, 0, 9, 4, 42
"f:\SimpleRTS\SimpleRTS\Simplified_RTS\Assets\Photon\PhotonUnityNetworking\Demos\PunCockpit\Scripts\ReadOnlyProperties\PropertyListenerBase.cs", "C#", 28, 0, 0, 0, 0, 9, 6, 43
"f:\SimpleRTS\SimpleRTS\Simplified_RTS\Assets\Photon\PhotonUnityNetworking\Demos\PunCockpit\Scripts\ReadOnlyProperties\ServerAddressProperty.cs", "C#", 29, 0, 0, 0, 0, 9, 4, 42
"f:\SimpleRTS\SimpleRTS\Simplified_RTS\Assets\Photon\PhotonUnityNetworking\Demos\PunCockpit\Scripts\ReadOnlyProperties\ServerProperty.cs", "C#", 19, 0, 0, 0, 0, 9, 7, 35
"f:\SimpleRTS\SimpleRTS\Simplified_RTS\Assets\Photon\PhotonUnityNetworking\Demos\PunCockpit\Scripts\ScoreHelper.cs", "C#", 21, 0, 0, 0, 0, 7, 13, 41
"f:\SimpleRTS\SimpleRTS\Simplified_RTS\Assets\Photon\PhotonUnityNetworking\Demos\PunCockpit\Scripts\ThirdParty\PunCockpitEmbed.cs", "C#", 55, 0, 0, 0, 0, 17, 30, 102
"f:\SimpleRTS\SimpleRTS\Simplified_RTS\Assets\Photon\PhotonUnityNetworking\Demos\Shared Assets\Scripts\DocLinks.cs", "C#", 63, 0, 0, 0, 0, 72, 23, 158
"f:\SimpleRTS\SimpleRTS\Simplified_RTS\Assets\Photon\PhotonUnityNetworking\Demos\Shared Assets\Scripts\ThirdPersonCharacter.cs", "C#", 172, 0, 0, 0, 0, 23, 31, 226
"f:\SimpleRTS\SimpleRTS\Simplified_RTS\Assets\Photon\PhotonUnityNetworking\Demos\Shared Assets\Scripts\ThirdPersonUserControl.cs", "C#", 54, 0, 0, 0, 0, 10, 11, 75
"f:\SimpleRTS\SimpleRTS\Simplified_RTS\Assets\Photon\PhotonUnityNetworking\Demos\Shared Assets\Skin\3dText.shader", "ShaderLab", 0, 0, 0, 0, 17, 0, 1, 18
"f:\SimpleRTS\SimpleRTS\Simplified_RTS\Assets\Photon\PhotonUnityNetworking\Demos\WebRpcImplementationExample.cs", "C#", 84, 0, 0, 0, 0, 19, 8, 111
"f:\SimpleRTS\SimpleRTS\Simplified_RTS\Assets\Photon\PhotonUnityNetworking\UtilityScripts\Culling\CullArea.cs", "C#", 264, 0, 0, 0, 0, 142, 72, 478
"f:\SimpleRTS\SimpleRTS\Simplified_RTS\Assets\Photon\PhotonUnityNetworking\UtilityScripts\Culling\CullingHandler.cs", "C#", 150, 0, 0, 0, 0, 44, 40, 234
"f:\SimpleRTS\SimpleRTS\Simplified_RTS\Assets\Photon\PhotonUnityNetworking\UtilityScripts\Culling\Editor\CullAreaEditor.cs", "C#", 183, 0, 0, 0, 0, 25, 57, 265
"f:\SimpleRTS\SimpleRTS\Simplified_RTS\Assets\Photon\PhotonUnityNetworking\UtilityScripts\Debugging\PhotonLagSimulationGui.cs", "C#", 67, 0, 0, 0, 0, 21, 21, 109
"f:\SimpleRTS\SimpleRTS\Simplified_RTS\Assets\Photon\PhotonUnityNetworking\UtilityScripts\Debugging\PhotonStatsGui.cs", "C#", 114, 0, 0, 0, 0, 32, 24, 170
"f:\SimpleRTS\SimpleRTS\Simplified_RTS\Assets\Photon\PhotonUnityNetworking\UtilityScripts\Debugging\PointedAtGameObjectInfo.cs", "C#", 56, 0, 0, 0, 0, 12, 16, 84
"f:\SimpleRTS\SimpleRTS\Simplified_RTS\Assets\Photon\PhotonUnityNetworking\UtilityScripts\Debugging\StatesGui.cs", "C#", 172, 0, 0, 0, 0, 12, 24, 208
"f:\SimpleRTS\SimpleRTS\Simplified_RTS\Assets\Photon\PhotonUnityNetworking\UtilityScripts\PhotonPlayer\Editor\PhotonTeamsManagerInspector.cs", "C#", 217, 0, 0, 0, 0, 18, 11, 246
"f:\SimpleRTS\SimpleRTS\Simplified_RTS\Assets\Photon\PhotonUnityNetworking\UtilityScripts\PhotonPlayer\Editor\PlayerNumberingInspector.cs", "C#", 43, 0, 0, 0, 0, 13, 11, 67
"f:\SimpleRTS\SimpleRTS\Simplified_RTS\Assets\Photon\PhotonUnityNetworking\UtilityScripts\PhotonPlayer\Editor\PunTeamsInspector.cs", "C#", 43, 0, 0, 0, 0, 9, 13, 65
"f:\SimpleRTS\SimpleRTS\Simplified_RTS\Assets\Photon\PhotonUnityNetworking\UtilityScripts\PhotonPlayer\PhotonTeamsManager.cs", "C#", 440, 0, 0, 0, 0, 129, 59, 628
"f:\SimpleRTS\SimpleRTS\Simplified_RTS\Assets\Photon\PhotonUnityNetworking\UtilityScripts\PhotonPlayer\PlayerNumbering.cs", "C#", 160, 0, 0, 0, 0, 55, 52, 267
"f:\SimpleRTS\SimpleRTS\Simplified_RTS\Assets\Photon\PhotonUnityNetworking\UtilityScripts\PhotonPlayer\PunPlayerScores.cs", "C#", 39, 0, 0, 0, 0, 12, 11, 62
"f:\SimpleRTS\SimpleRTS\Simplified_RTS\Assets\Photon\PhotonUnityNetworking\UtilityScripts\PhotonPlayer\PunTeams.cs", "C#", 98, 0, 0, 0, 0, 35, 23, 156
"f:\SimpleRTS\SimpleRTS\Simplified_RTS\Assets\Photon\PhotonUnityNetworking\UtilityScripts\PhotonView\SmoothSyncMovement.cs", "C#", 50, 0, 0, 0, 0, 15, 7, 72
"f:\SimpleRTS\SimpleRTS\Simplified_RTS\Assets\Photon\PhotonUnityNetworking\UtilityScripts\Prototyping\ConnectAndJoinRandom.cs", "C#", 53, 0, 0, 0, 0, 53, 31, 137
"f:\SimpleRTS\SimpleRTS\Simplified_RTS\Assets\Photon\PhotonUnityNetworking\UtilityScripts\Prototyping\MoveByKeys.cs", "C#", 64, 0, 0, 0, 0, 33, 14, 111
"f:\SimpleRTS\SimpleRTS\Simplified_RTS\Assets\Photon\PhotonUnityNetworking\UtilityScripts\Prototyping\OnClickDestroy.cs", "C#", 33, 0, 0, 0, 0, 29, 10, 72
"f:\SimpleRTS\SimpleRTS\Simplified_RTS\Assets\Photon\PhotonUnityNetworking\UtilityScripts\Prototyping\OnClickInstantiate.cs", "C#", 30, 0, 0, 0, 0, 14, 12, 56
"f:\SimpleRTS\SimpleRTS\Simplified_RTS\Assets\Photon\PhotonUnityNetworking\UtilityScripts\Prototyping\OnClickRpc.cs", "C#", 57, 0, 0, 0, 0, 12, 20, 89
"f:\SimpleRTS\SimpleRTS\Simplified_RTS\Assets\Photon\PhotonUnityNetworking\UtilityScripts\Prototyping\OnEscapeQuit.cs", "C#", 17, 0, 0, 0, 0, 13, 2, 32
"f:\SimpleRTS\SimpleRTS\Simplified_RTS\Assets\Photon\PhotonUnityNetworking\UtilityScripts\Prototyping\OnJoinedInstantiate.cs", "C#", 300, 0, 0, 0, 0, 58, 93, 451
"f:\SimpleRTS\SimpleRTS\Simplified_RTS\Assets\Photon\PhotonUnityNetworking\UtilityScripts\Prototyping\OnStartDelete.cs", "C#", 11, 0, 0, 0, 0, 11, 2, 24
"f:\SimpleRTS\SimpleRTS\Simplified_RTS\Assets\Photon\PhotonUnityNetworking\UtilityScripts\Room\CountdownTimer.cs", "C#", 101, 0, 0, 0, 0, 33, 42, 176
"f:\SimpleRTS\SimpleRTS\Simplified_RTS\Assets\Photon\PhotonUnityNetworking\UtilityScripts\TurnBased\PunTurnManager.cs", "C#", 206, 0, 0, 0, 0, 146, 78, 430
"f:\SimpleRTS\SimpleRTS\Simplified_RTS\Assets\Photon\PhotonUnityNetworking\UtilityScripts\UI\ButtonInsideScrollList.cs", "C#", 31, 0, 0, 0, 0, 14, 8, 53
"f:\SimpleRTS\SimpleRTS\Simplified_RTS\Assets\Photon\PhotonUnityNetworking\UtilityScripts\UI\EventSystemSpawner.cs", "C#", 18, 0, 0, 0, 0, 13, 3, 34
"f:\SimpleRTS\SimpleRTS\Simplified_RTS\Assets\Photon\PhotonUnityNetworking\UtilityScripts\UI\GraphicToggleIsOnTransition.cs", "C#", 41, 0, 0, 0, 0, 11, 12, 64
"f:\SimpleRTS\SimpleRTS\Simplified_RTS\Assets\Photon\PhotonUnityNetworking\UtilityScripts\UI\OnPointerOverTooltip.cs", "C#", 24, 0, 0, 0, 0, 10, 11, 45
"f:\SimpleRTS\SimpleRTS\Simplified_RTS\Assets\Photon\PhotonUnityNetworking\UtilityScripts\UI\TabViewManager.cs", "C#", 65, 0, 0, 0, 0, 33, 25, 123
"f:\SimpleRTS\SimpleRTS\Simplified_RTS\Assets\Photon\PhotonUnityNetworking\UtilityScripts\UI\TextButtonTransition.cs", "C#", 38, 0, 0, 0, 0, 20, 12, 70
"f:\SimpleRTS\SimpleRTS\Simplified_RTS\Assets\Photon\PhotonUnityNetworking\UtilityScripts\UI\TextToggleIsOnTransition.cs", "C#", 41, 0, 0, 0, 0, 26, 19, 86
"f:\SimpleRTS\SimpleRTS\Simplified_RTS\Assets\Photon\PhotonUnityNetworking\link.xml", "XML", 0, 14, 0, 0, 0, 0, 0, 14
"f:\SimpleRTS\SimpleRTS\Simplified_RTS\Assets\Plugins\HoudiniEngineUnity\Editor\HEU_EditorApp.cs", "C#", 88, 0, 0, 0, 0, 32, 16, 136
"f:\SimpleRTS\SimpleRTS\Simplified_RTS\Assets\Plugins\HoudiniEngineUnity\Editor\HEU_EditorMenu.cs", "C#", 269, 0, 0, 0, 0, 59, 48, 376
"f:\SimpleRTS\SimpleRTS\Simplified_RTS\Assets\Plugins\HoudiniEngineUnity\Editor\HEU_EditorStrings.cs", "C#", 26, 0, 0, 0, 0, 29, 9, 64
"f:\SimpleRTS\SimpleRTS\Simplified_RTS\Assets\Plugins\HoudiniEngineUnity\Editor\UI\HEU_CurveUI.cs", "C#", 1039, 0, 0, 0, 0, 160, 250, 1449
"f:\SimpleRTS\SimpleRTS\Simplified_RTS\Assets\Plugins\HoudiniEngineUnity\Editor\UI\HEU_DragHandleMulti.cs", "C#", 219, 0, 0, 0, 0, 42, 54, 315
"f:\SimpleRTS\SimpleRTS\Simplified_RTS\Assets\Plugins\HoudiniEngineUnity\Editor\UI\HEU_EditorUI.cs", "C#", 375, 0, 0, 0, 0, 43, 77, 495
"f:\SimpleRTS\SimpleRTS\Simplified_RTS\Assets\Plugins\HoudiniEngineUnity\Editor\UI\HEU_GeoSyncUI.cs", "C#", 80, 0, 0, 0, 0, 27, 28, 135
"f:\SimpleRTS\SimpleRTS\Simplified_RTS\Assets\Plugins\HoudiniEngineUnity\Editor\UI\HEU_HandlesUI.cs", "C#", 223, 0, 0, 0, 0, 29, 40, 292
"f:\SimpleRTS\SimpleRTS\Simplified_RTS\Assets\Plugins\HoudiniEngineUnity\Editor\UI\HEU_HoudiniAssetDebugUI.cs", "C#", 37, 0, 0, 0, 0, 35, 16, 88
"f:\SimpleRTS\SimpleRTS\Simplified_RTS\Assets\Plugins\HoudiniEngineUnity\Editor\UI\HEU_HoudiniAssetUI.cs", "C#", 809, 0, 0, 0, 0, 104, 192, 1105
"f:\SimpleRTS\SimpleRTS\Simplified_RTS\Assets\Plugins\HoudiniEngineUnity\Editor\UI\HEU_InputNodeUI.cs", "C#", 238, 0, 0, 0, 0, 45, 56, 339
"f:\SimpleRTS\SimpleRTS\Simplified_RTS\Assets\Plugins\HoudiniEngineUnity\Editor\UI\HEU_InstanceInputUI.cs", "C#", 135, 0, 0, 0, 0, 67, 52, 254
"f:\SimpleRTS\SimpleRTS\Simplified_RTS\Assets\Plugins\HoudiniEngineUnity\Editor\UI\HEU_NodeSyncUI.cs", "C#", 81, 0, 0, 0, 0, 27, 27, 135
"f:\SimpleRTS\SimpleRTS\Simplified_RTS\Assets\Plugins\HoudiniEngineUnity\Editor\UI\HEU_PDGAssetLinkUI.cs", "C#", 415, 0, 0, 0, 0, 71, 112, 598
"f:\SimpleRTS\SimpleRTS\Simplified_RTS\Assets\Plugins\HoudiniEngineUnity\Editor\UI\HEU_ParameterUI.cs", "C#", 1185, 0, 0, 0, 0, 178, 247, 1610
"f:\SimpleRTS\SimpleRTS\Simplified_RTS\Assets\Plugins\HoudiniEngineUnity\Editor\UI\HEU_SelectionWindow.cs", "C#", 301, 0, 0, 0, 0, 32, 75, 408
"f:\SimpleRTS\SimpleRTS\Simplified_RTS\Assets\Plugins\HoudiniEngineUnity\Editor\UI\HEU_SessionSyncWindow.cs", "C#", 679, 0, 0, 0, 0, 180, 144, 1003
"f:\SimpleRTS\SimpleRTS\Simplified_RTS\Assets\Plugins\HoudiniEngineUnity\Editor\UI\HEU_SettingsWindow.cs", "C#", 657, 0, 0, 0, 0, 35, 77, 769
"f:\SimpleRTS\SimpleRTS\Simplified_RTS\Assets\Plugins\HoudiniEngineUnity\Editor\UI\HEU_ShelfToolsWindow.cs", "C#", 244, 0, 0, 0, 0, 32, 63, 339
"f:\SimpleRTS\SimpleRTS\Simplified_RTS\Assets\Plugins\HoudiniEngineUnity\Editor\UI\HEU_ToolsUI.cs", "C#", 1226, 0, 0, 0, 0, 129, 303, 1658
"f:\SimpleRTS\SimpleRTS\Simplified_RTS\Assets\Plugins\HoudiniEngineUnity\Scenes\ParamModifierExample.unity", "C# (Unity)", 0, 0, 0, 2343, 0, 0, 1, 2344
"f:\SimpleRTS\SimpleRTS\Simplified_RTS\Assets\Plugins\HoudiniEngineUnity\Scripts\Asset\HEU_AssetEvents.cs", "C#", 19, 0, 0, 0, 0, 46, 10, 75
"f:\SimpleRTS\SimpleRTS\Simplified_RTS\Assets\Plugins\HoudiniEngineUnity\Scripts\Asset\HEU_AssetPreset.cs", "C#", 192, 0, 0, 0, 0, 87, 51, 330
"f:\SimpleRTS\SimpleRTS\Simplified_RTS\Assets\Plugins\HoudiniEngineUnity\Scripts\Asset\HEU_AssetUpdater.cs", "C#", 134, 0, 0, 0, 0, 43, 23, 200
"f:\SimpleRTS\SimpleRTS\Simplified_RTS\Assets\Plugins\HoudiniEngineUnity\Scripts\Asset\HEU_Curve.cs", "C#", 385, 0, 0, 0, 0, 63, 87, 535
"f:\SimpleRTS\SimpleRTS\Simplified_RTS\Assets\Plugins\HoudiniEngineUnity\Scripts\Asset\HEU_GeneratedOutput.cs", "C#", 221, 0, 0, 0, 0, 86, 36, 343
"f:\SimpleRTS\SimpleRTS\Simplified_RTS\Assets\Plugins\HoudiniEngineUnity\Scripts\Asset\HEU_GeoNode.cs", "C#", 745, 0, 0, 0, 0, 174, 140, 1059
"f:\SimpleRTS\SimpleRTS\Simplified_RTS\Assets\Plugins\HoudiniEngineUnity\Scripts\Asset\HEU_HoudiniAsset.cs", "C#", 2957, 0, 0, 0, 0, 730, 647, 4334
"f:\SimpleRTS\SimpleRTS\Simplified_RTS\Assets\Plugins\HoudiniEngineUnity\Scripts\Asset\HEU_HoudiniAssetRoot.cs", "C#", 56, 0, 0, 0, 0, 54, 19, 129
"f:\SimpleRTS\SimpleRTS\Simplified_RTS\Assets\Plugins\HoudiniEngineUnity\Scripts\Asset\HEU_InputNode.cs", "C#", 839, 0, 0, 0, 0, 126, 191, 1156
"f:\SimpleRTS\SimpleRTS\Simplified_RTS\Assets\Plugins\HoudiniEngineUnity\Scripts\Asset\HEU_InstanceInputUIState.cs", "C#", 19, 0, 0, 0, 0, 33, 6, 58
"f:\SimpleRTS\SimpleRTS\Simplified_RTS\Assets\Plugins\HoudiniEngineUnity\Scripts\Asset\HEU_ObjectInstanceInfo.cs", "C#", 22, 0, 0, 0, 0, 38, 10, 70
"f:\SimpleRTS\SimpleRTS\Simplified_RTS\Assets\Plugins\HoudiniEngineUnity\Scripts\Asset\HEU_ObjectNode.cs", "C#", 519, 0, 0, 0, 0, 151, 103, 773
"f:\SimpleRTS\SimpleRTS\Simplified_RTS\Assets\Plugins\HoudiniEngineUnity\Scripts\Asset\HEU_PartData.cs", "C#", 1463, 0, 0, 0, 0, 358, 306, 2127
"f:\SimpleRTS\SimpleRTS\Simplified_RTS\Assets\Plugins\HoudiniEngineUnity\Scripts\Attributes\HEU_AttributeData.cs", "C#", 65, 0, 0, 0, 0, 25, 13, 103
"f:\SimpleRTS\SimpleRTS\Simplified_RTS\Assets\Plugins\HoudiniEngineUnity\Scripts\Attributes\HEU_AttributesStore.cs", "C#", 852, 0, 0, 0, 0, 78, 161, 1091
"f:\SimpleRTS\SimpleRTS\Simplified_RTS\Assets\Plugins\HoudiniEngineUnity\Scripts\Attributes\HEU_OutputAttribute.cs", "C#", 15, 0, 0, 0, 0, 32, 7, 54
"f:\SimpleRTS\SimpleRTS\Simplified_RTS\Assets\Plugins\HoudiniEngineUnity\Scripts\Attributes\HEU_OutputAttributesStore.cs", "C#", 32, 0, 0, 0, 0, 41, 7, 80
"f:\SimpleRTS\SimpleRTS\Simplified_RTS\Assets\Plugins\HoudiniEngineUnity\Scripts\Core\HEU_AssetDatabase.cs", "C#", 895, 0, 0, 0, 0, 273, 125, 1293
"f:\SimpleRTS\SimpleRTS\Simplified_RTS\Assets\Plugins\HoudiniEngineUnity\Scripts\Core\HEU_Defines.cs", "C#", 216, 0, 0, 0, 0, 78, 65, 359
"f:\SimpleRTS\SimpleRTS\Simplified_RTS\Assets\Plugins\HoudiniEngineUnity\Scripts\Core\HEU_HAPIUtility.cs", "C#", 855, 0, 0, 0, 0, 282, 189, 1326
"f:\SimpleRTS\SimpleRTS\Simplified_RTS\Assets\Plugins\HoudiniEngineUnity\Scripts\Core\HEU_HoudiniEngineError.cs", "C#", 22, 0, 0, 0, 0, 28, 11, 61
"f:\SimpleRTS\SimpleRTS\Simplified_RTS\Assets\Plugins\HoudiniEngineUnity\Scripts\Core\HEU_Platform.cs", "C#", 370, 0, 0, 0, 0, 120, 75, 565
"f:\SimpleRTS\SimpleRTS\Simplified_RTS\Assets\Plugins\HoudiniEngineUnity\Scripts\Core\HEU_PlatformWin.cs", "C#", 111, 0, 0, 0, 0, 65, 24, 200
"f:\SimpleRTS\SimpleRTS\Simplified_RTS\Assets\Plugins\HoudiniEngineUnity\Scripts\Core\HEU_PluginSettings.cs", "C#", 774, 0, 0, 0, 0, 33, 68, 875
"f:\SimpleRTS\SimpleRTS\Simplified_RTS\Assets\Plugins\HoudiniEngineUnity\Scripts\Core\HEU_PluginStorage.cs", "C#", 530, 0, 0, 0, 0, 129, 85, 744
"f:\SimpleRTS\SimpleRTS\Simplified_RTS\Assets\Plugins\HoudiniEngineUnity\Scripts\Examples\HEU_ExampleEvergreenQuery.cs", "C#", 239, 0, 0, 0, 0, 136, 56, 431
"f:\SimpleRTS\SimpleRTS\Simplified_RTS\Assets\Plugins\HoudiniEngineUnity\Scripts\Examples\HEU_ExampleInstanceCustomAttribute.cs", "C#", 89, 0, 0, 0, 0, 51, 21, 161
"f:\SimpleRTS\SimpleRTS\Simplified_RTS\Assets\Plugins\HoudiniEngineUnity\Scripts\Examples\HEU_ScriptCallbackExample.cs", "C#", 15, 0, 0, 0, 0, 29, 7, 51
"f:\SimpleRTS\SimpleRTS\Simplified_RTS\Assets\Plugins\HoudiniEngineUnity\Scripts\Examples\HEU_ScriptMeshInputUVLayoutExample.cs", "C#", 135, 0, 0, 0, 0, 80, 37, 252
"f:\SimpleRTS\SimpleRTS\Simplified_RTS\Assets\Plugins\HoudiniEngineUnity\Scripts\Examples\HEU_ScriptParameterExample.cs", "C#", 40, 0, 0, 0, 0, 41, 24, 105
"f:\SimpleRTS\SimpleRTS\Simplified_RTS\Assets\Plugins\HoudiniEngineUnity\Scripts\HAPI\HEU_HAPIData.cs", "C#", 1157, 0, 0, 0, 0, 191, 287, 1635
"f:\SimpleRTS\SimpleRTS\Simplified_RTS\Assets\Plugins\HoudiniEngineUnity\Scripts\HAPI\HEU_HAPIImports.cs", "C#", 1337, 0, 0, 0, 0, 56, 234, 1627
"f:\SimpleRTS\SimpleRTS\Simplified_RTS\Assets\Plugins\HoudiniEngineUnity\Scripts\HAPI\HEU_HAPIImportsPDG.cs", "C#", 166, 0, 0, 0, 0, 32, 29, 227
"f:\SimpleRTS\SimpleRTS\Simplified_RTS\Assets\Plugins\HoudiniEngineUnity\Scripts\HEU_HoudiniVersion.cs", "C#", 46, 0, 0, 0, 0, 35, 26, 107
"f:\SimpleRTS\SimpleRTS\Simplified_RTS\Assets\Plugins\HoudiniEngineUnity\Scripts\Handles\HEU_Handle.cs", "C#", 349, 0, 0, 0, 0, 35, 87, 471
"f:\SimpleRTS\SimpleRTS\Simplified_RTS\Assets\Plugins\HoudiniEngineUnity\Scripts\Handles\HEU_HandleParamBinding.cs", "C#", 23, 0, 0, 0, 0, 30, 9, 62
"f:\SimpleRTS\SimpleRTS\Simplified_RTS\Assets\Plugins\HoudiniEngineUnity\Scripts\PDG\HEU_PDGAssetLink.cs", "C#", 708, 0, 0, 0, 0, 174, 152, 1034
"f:\SimpleRTS\SimpleRTS\Simplified_RTS\Assets\Plugins\HoudiniEngineUnity\Scripts\PDG\HEU_PDGObjects.cs", "C#", 109, 0, 0, 0, 0, 45, 34, 188
"f:\SimpleRTS\SimpleRTS\Simplified_RTS\Assets\Plugins\HoudiniEngineUnity\Scripts\PDG\HEU_PDGSession.cs", "C#", 521, 0, 0, 0, 0, 123, 92, 736
"f:\SimpleRTS\SimpleRTS\Simplified_RTS\Assets\Plugins\HoudiniEngineUnity\Scripts\Parameters\HEU_ParameterData.cs", "C#", 92, 0, 0, 0, 0, 60, 37, 189
"f:\SimpleRTS\SimpleRTS\Simplified_RTS\Assets\Plugins\HoudiniEngineUnity\Scripts\Parameters\HEU_ParameterModifier.cs", "C#", 33, 0, 0, 0, 0, 32, 9, 74
"f:\SimpleRTS\SimpleRTS\Simplified_RTS\Assets\Plugins\HoudiniEngineUnity\Scripts\Parameters\HEU_ParameterUtility.cs", "C#", 311, 0, 0, 0, 0, 31, 32, 374
"f:\SimpleRTS\SimpleRTS\Simplified_RTS\Assets\Plugins\HoudiniEngineUnity\Scripts\Parameters\HEU_Parameters.cs", "C#", 939, 0, 0, 0, 0, 195, 182, 1316
"f:\SimpleRTS\SimpleRTS\Simplified_RTS\Assets\Plugins\HoudiniEngineUnity\Scripts\Render\HEU_MaterialData.cs", "C#", 115, 0, 0, 0, 0, 76, 33, 224
"f:\SimpleRTS\SimpleRTS\Simplified_RTS\Assets\Plugins\HoudiniEngineUnity\Scripts\Render\HEU_MaterialFactory.cs", "C#", 493, 0, 0, 0, 0, 75, 99, 667
"f:\SimpleRTS\SimpleRTS\Simplified_RTS\Assets\Plugins\HoudiniEngineUnity\Scripts\Render\HEU_UnityMaterialInfo.cs", "C#", 15, 0, 0, 0, 0, 28, 3, 46
"f:\SimpleRTS\SimpleRTS\Simplified_RTS\Assets\Plugins\HoudiniEngineUnity\Scripts\Sessions\HEU_SessionBase.cs", "C#", 839, 0, 0, 0, 0, 529, 213, 1581
"f:\SimpleRTS\SimpleRTS\Simplified_RTS\Assets\Plugins\HoudiniEngineUnity\Scripts\Sessions\HEU_SessionData.cs", "C#", 198, 0, 0, 0, 0, 35, 40, 273
"f:\SimpleRTS\SimpleRTS\Simplified_RTS\Assets\Plugins\HoudiniEngineUnity\Scripts\Sessions\HEU_SessionHAPI.cs", "C#", 1564, 0, 0, 0, 0, 588, 287, 2439
"f:\SimpleRTS\SimpleRTS\Simplified_RTS\Assets\Plugins\HoudiniEngineUnity\Scripts\Sessions\HEU_SessionManager.cs", "C#", 767, 0, 0, 0, 0, 268, 120, 1155
"f:\SimpleRTS\SimpleRTS\Simplified_RTS\Assets\Plugins\HoudiniEngineUnity\Scripts\Sessions\HEU_SessionPDG.cs", "C#", 139, 0, 0, 0, 0, 31, 30, 200
"f:\SimpleRTS\SimpleRTS\Simplified_RTS\Assets\Plugins\HoudiniEngineUnity\Scripts\Sessions\HEU_SessionSyncInfo.cs", "C#", 41, 0, 0, 0, 0, 43, 14, 98
"f:\SimpleRTS\SimpleRTS\Simplified_RTS\Assets\Plugins\HoudiniEngineUnity\Scripts\Sync\HEU_BaseSync.cs", "C#", 815, 0, 0, 0, 0, 96, 202, 1113
"f:\SimpleRTS\SimpleRTS\Simplified_RTS\Assets\Plugins\HoudiniEngineUnity\Scripts\Sync\HEU_GeoSync.cs", "C#", 31, 0, 0, 0, 0, 31, 12, 74
"f:\SimpleRTS\SimpleRTS\Simplified_RTS\Assets\Plugins\HoudiniEngineUnity\Scripts\Sync\HEU_NodeSync.cs", "C#", 149, 0, 0, 0, 0, 42, 48, 239
"f:\SimpleRTS\SimpleRTS\Simplified_RTS\Assets\Plugins\HoudiniEngineUnity\Scripts\Tasks\HEU_Task.cs", "C#", 125, 0, 0, 0, 0, 34, 26, 185
"f:\SimpleRTS\SimpleRTS\Simplified_RTS\Assets\Plugins\HoudiniEngineUnity\Scripts\Tasks\HEU_TaskManager.cs", "C#", 147, 0, 0, 0, 0, 45, 22, 214
"f:\SimpleRTS\SimpleRTS\Simplified_RTS\Assets\Plugins\HoudiniEngineUnity\Scripts\Tasks\HEU_ThreadManager.cs", "C#", 93, 0, 0, 0, 0, 45, 23, 161
"f:\SimpleRTS\SimpleRTS\Simplified_RTS\Assets\Plugins\HoudiniEngineUnity\Scripts\Tasks\HEU_ThreadedLoadBuffers.cs", "C#", 95, 0, 0, 0, 0, 32, 31, 158
"f:\SimpleRTS\SimpleRTS\Simplified_RTS\Assets\Plugins\HoudiniEngineUnity\Scripts\Tasks\HEU_ThreadedTask.cs", "C#", 183, 0, 0, 0, 0, 87, 45, 315
"f:\SimpleRTS\SimpleRTS\Simplified_RTS\Assets\Plugins\HoudiniEngineUnity\Scripts\Tasks\HEU_ThreadedTaskLoadGeo.cs", "C#", 874, 0, 0, 0, 0, 148, 204, 1226
"f:\SimpleRTS\SimpleRTS\Simplified_RTS\Assets\Plugins\HoudiniEngineUnity\Scripts\Tests\HEU_AssetEventReceiverTest.cs", "C#", 18, 0, 0, 0, 0, 28, 6, 52
"f:\SimpleRTS\SimpleRTS\Simplified_RTS\Assets\Plugins\HoudiniEngineUnity\Scripts\Utility\HEU_EditorUtility.cs", "C#", 938, 0, 0, 0, 0, 183, 125, 1246
"f:\SimpleRTS\SimpleRTS\Simplified_RTS\Assets\Plugins\HoudiniEngineUnity\Scripts\Utility\HEU_GeneralUtility.cs", "C#", 1348, 0, 0, 0, 0, 361, 201, 1910
"f:\SimpleRTS\SimpleRTS\Simplified_RTS\Assets\Plugins\HoudiniEngineUnity\Scripts\Utility\HEU_GenerateGeoCache.cs", "C#", 1738, 0, 0, 0, 0, 322, 398, 2458
"f:\SimpleRTS\SimpleRTS\Simplified_RTS\Assets\Plugins\HoudiniEngineUnity\Scripts\Utility\HEU_GeoGroup.cs", "C#", 40, 0, 0, 0, 0, 35, 10, 85
"f:\SimpleRTS\SimpleRTS\Simplified_RTS\Assets\Plugins\HoudiniEngineUnity\Scripts\Utility\HEU_GeometryUtility.cs", "C#", 213, 0, 0, 0, 0, 63, 55, 331
"f:\SimpleRTS\SimpleRTS\Simplified_RTS\Assets\Plugins\HoudiniEngineUnity\Scripts\Utility\HEU_InputData.cs", "C#", 8, 0, 0, 0, 0, 29, 3, 40
"f:\SimpleRTS\SimpleRTS\Simplified_RTS\Assets\Plugins\HoudiniEngineUnity\Scripts\Utility\HEU_InputInterface.cs", "C#", 23, 0, 0, 0, 0, 62, 11, 96
"f:\SimpleRTS\SimpleRTS\Simplified_RTS\Assets\Plugins\HoudiniEngineUnity\Scripts\Utility\HEU_InputInterfaceMesh.cs", "C#", 528, 0, 0, 0, 0, 114, 111, 753
"f:\SimpleRTS\SimpleRTS\Simplified_RTS\Assets\Plugins\HoudiniEngineUnity\Scripts\Utility\HEU_InputInterfaceTerrain.cs", "C#", 482, 0, 0, 0, 0, 165, 113, 760
"f:\SimpleRTS\SimpleRTS\Simplified_RTS\Assets\Plugins\HoudiniEngineUnity\Scripts\Utility\HEU_InputMeshUtility.cs", "C#", 188, 0, 0, 0, 0, 41, 35, 264
"f:\SimpleRTS\SimpleRTS\Simplified_RTS\Assets\Plugins\HoudiniEngineUnity\Scripts\Utility\HEU_InputUtility.cs", "C#", 202, 0, 0, 0, 0, 104, 39, 345
"f:\SimpleRTS\SimpleRTS\Simplified_RTS\Assets\Plugins\HoudiniEngineUnity\Scripts\Utility\HEU_MeshData.cs", "C#", 18, 0, 0, 0, 0, 28, 6, 52
"f:\SimpleRTS\SimpleRTS\Simplified_RTS\Assets\Plugins\HoudiniEngineUnity\Scripts\Utility\HEU_MeshIndexFormat.cs", "C#", 32, 0, 0, 0, 0, 38, 6, 76
"f:\SimpleRTS\SimpleRTS\Simplified_RTS\Assets\Plugins\HoudiniEngineUnity\Scripts\Utility\HEU_SerializableDictionary.cs", "C#", 202, 0, 0, 0, 0, 32, 27, 261
"f:\SimpleRTS\SimpleRTS\Simplified_RTS\Assets\Plugins\HoudiniEngineUnity\Scripts\Utility\HEU_ShelfTools.cs", "C#", 575, 0, 0, 0, 0, 46, 125, 746
"f:\SimpleRTS\SimpleRTS\Simplified_RTS\Assets\Plugins\HoudiniEngineUnity\Scripts\Utility\HEU_SimpleJSON.cs", "C#", 1087, 0, 0, 0, 0, 46, 143, 1276
"f:\SimpleRTS\SimpleRTS\Simplified_RTS\Assets\Plugins\HoudiniEngineUnity\Scripts\Utility\HEU_SimpleJSONUnity.cs", "C#", 317, 0, 0, 0, 0, 37, 12, 366
"f:\SimpleRTS\SimpleRTS\Simplified_RTS\Assets\Plugins\HoudiniEngineUnity\Scripts\Utility\HEU_TerrainUtility.cs", "C#", 810, 0, 0, 0, 0, 260, 167, 1237
"f:\SimpleRTS\SimpleRTS\Simplified_RTS\Assets\Plugins\HoudiniEngineUnity\Scripts\Utility\HEU_ToolsInfo.cs", "C#", 45, 0, 0, 0, 0, 30, 26, 101
"f:\SimpleRTS\SimpleRTS\Simplified_RTS\Assets\Plugins\HoudiniEngineUnity\Scripts\Utility\HEU_VolumeCache.cs", "C#", 913, 0, 0, 0, 0, 182, 201, 1296
"f:\SimpleRTS\SimpleRTS\Simplified_RTS\Assets\Plugins\HoudiniEngineUnity\Shaders\HoudiniAlphaSpecularVertexColor.shader", "ShaderLab", 0, 0, 0, 0, 34, 25, 8, 67
"f:\SimpleRTS\SimpleRTS\Simplified_RTS\Assets\Plugins\HoudiniEngineUnity\Shaders\HoudiniLineShader.shader", "ShaderLab", 0, 0, 0, 0, 39, 26, 10, 75
"f:\SimpleRTS\SimpleRTS\Simplified_RTS\Assets\Plugins\HoudiniEngineUnity\Shaders\HoudiniSpecularVertexColor.shader", "ShaderLab", 0, 0, 0, 0, 34, 25, 7, 66
"f:\SimpleRTS\SimpleRTS\Simplified_RTS\Assets\Scenes\Battlefield.unity", "C# (Unity)", 0, 0, 0, 8795, 0, 0, 1, 8796
"f:\SimpleRTS\SimpleRTS\Simplified_RTS\Assets\Scenes\Battlefield_Online.unity", "C# (Unity)", 0, 0, 0, 8791, 0, 0, 1, 8792
"f:\SimpleRTS\SimpleRTS\Simplified_RTS\Assets\Scenes\OnlineRoom.unity", "C# (Unity)", 0, 0, 0, 3009, 0, 0, 1, 3010
"f:\SimpleRTS\SimpleRTS\Simplified_RTS\Assets\Scenes\ShaderTestScene.unity", "C# (Unity)", 0, 0, 0, 999, 0, 0, 1, 1000
"f:\SimpleRTS\SimpleRTS\Simplified_RTS\Assets\Scenes\TestScene.unity", "C# (Unity)", 0, 0, 0, 588, 0, 0, 1, 589
"f:\SimpleRTS\SimpleRTS\Simplified_RTS\Assets\Scripts\Controllers\Camera\CameraController.cs", "C#", 26, 0, 0, 0, 0, 0, 4, 30
"f:\SimpleRTS\SimpleRTS\Simplified_RTS\Assets\Scripts\Network\NetworkLobbyManager.cs", "C#", 143, 0, 0, 0, 0, 12, 38, 193
"f:\SimpleRTS\SimpleRTS\Simplified_RTS\Assets\Scripts\Player\Player.cs", "C#", 255, 0, 0, 0, 0, 34, 83, 372
"f:\SimpleRTS\SimpleRTS\Simplified_RTS\Assets\Scripts\Player\PlayerAI.cs", "C#", 127, 0, 0, 0, 0, 6, 32, 165
"f:\SimpleRTS\SimpleRTS\Simplified_RTS\Assets\Scripts\Player\PlayerOnline.cs", "C#", 21, 0, 0, 0, 0, 0, 6, 27
"f:\SimpleRTS\SimpleRTS\Simplified_RTS\Assets\Scripts\Player\PlayerOnline_BSide.cs", "C#", 6, 0, 0, 0, 0, 0, 2, 8
"f:\SimpleRTS\SimpleRTS\Simplified_RTS\Assets\Scripts\Render\SpriteRendererPlus.cs", "C#", 29, 0, 0, 0, 0, 1, 5, 35
"f:\SimpleRTS\SimpleRTS\Simplified_RTS\Assets\Scripts\UI\Local\FarmerDispatchUI.cs", "C#", 41, 0, 0, 0, 0, 0, 5, 46
"f:\SimpleRTS\SimpleRTS\Simplified_RTS\Assets\Scripts\UI\Local\UnitDispatchManagerUI.cs", "C#", 27, 0, 0, 0, 0, 3, 12, 42
"f:\SimpleRTS\SimpleRTS\Simplified_RTS\Assets\Scripts\UI\Local\UnitDispatchUI.cs", "C#", 73, 0, 0, 0, 0, 1, 15, 89
"f:\SimpleRTS\SimpleRTS\Simplified_RTS\Assets\Scripts\UI\Online\FarmerDispatchUI_Online.cs", "C#", 41, 0, 0, 0, 0, 0, 5, 46
"f:\SimpleRTS\SimpleRTS\Simplified_RTS\Assets\Scripts\UI\Online\NetworkRoomUI.cs", "C#", 23, 0, 0, 0, 0, 0, 4, 27
"f:\SimpleRTS\SimpleRTS\Simplified_RTS\Assets\Scripts\UI\Online\UnitDIspatchManagerUI_Online.cs", "C#", 29, 0, 0, 0, 0, 3, 13, 45
"f:\SimpleRTS\SimpleRTS\Simplified_RTS\Assets\Scripts\UI\PlayerHPUI.cs", "C#", 20, 0, 0, 0, 0, 0, 5, 25
"f:\SimpleRTS\SimpleRTS\Simplified_RTS\Assets\Scripts\UI\PlayerResouceUI.cs", "C#", 26, 0, 0, 0, 0, 0, 8, 34
"f:\SimpleRTS\SimpleRTS\Simplified_RTS\Assets\Scripts\UI\StartGameUI.cs", "C#", 21, 0, 0, 0, 0, 0, 6, 27
"f:\SimpleRTS\SimpleRTS\Simplified_RTS\Assets\Scripts\Units\Bullet.cs", "C#", 66, 0, 0, 0, 0, 6, 21, 93
"f:\SimpleRTS\SimpleRTS\Simplified_RTS\Assets\Scripts\Units\Door.cs", "C#", 32, 0, 0, 0, 0, 0, 8, 40
"f:\SimpleRTS\SimpleRTS\Simplified_RTS\Assets\Scripts\Units\Farmer.cs", "C#", 83, 0, 0, 0, 0, 16, 22, 121
"f:\SimpleRTS\SimpleRTS\Simplified_RTS\Assets\Scripts\Units\MeleeUnit.cs", "C#", 97, 0, 0, 0, 0, 5, 22, 124
"f:\SimpleRTS\SimpleRTS\Simplified_RTS\Assets\Scripts\Units\RangedAttackUnit.cs", "C#", 127, 0, 0, 0, 0, 10, 34, 171
"f:\SimpleRTS\SimpleRTS\Simplified_RTS\Assets\Scripts\Units\Unit.cs", "C#", 99, 0, 0, 0, 0, 8, 37, 144
"f:\SimpleRTS\SimpleRTS\Simplified_RTS\Assets\Shaders\Sprites\Sprite.shader", "ShaderLab", 0, 0, 0, 0, 198, 14, 81, 293
"f:\SimpleRTS\SimpleRTS\Simplified_RTS\Assets\Shaders\Sprites\SpriteShadow.shader", "ShaderLab", 0, 0, 0, 0, 173, 34, 55, 262
"f:\SimpleRTS\SimpleRTS\Simplified_RTS\Assets\Shaders\TestShader\ToonWater.shader", "ShaderLab", 0, 0, 0, 0, 338, 44, 104, 486
"f:\SimpleRTS\SimpleRTS\Simplified_RTS\Assets\TutorialInfo\Scripts\Editor\ReadmeEditor.cs", "C#", 126, 0, 0, 0, 0, 1, 32, 159
"f:\SimpleRTS\SimpleRTS\Simplified_RTS\Assets\TutorialInfo\Scripts\Readme.cs", "C#", 12, 0, 0, 0, 0, 0, 3, 15
"Total", "-", 71241, 5292, 47, 156416, 833, 22577, 16666, 273072